\\Main menu and settings
設定=Настройки
ランダム=Случайно
固定=Вот этот:
状態=Этап
事後=После кульминации
はい=Да
いいえ=Нет
ああああああああああああああああああああああ=Ах ах ах ах ах ах ах ах ах ах
画面=Экран
解像度変更=Изменение разрешения
フルスクリーン表示=Полный экран
3D背景の無効化=Отключить объёмный фон
FPS設定=Настройка частоты кадров
60FPS固定=Фиксированные 60 кадров
垂直同期=Вертикальная синхронизация
垂直同期（V-SYNC）=V-Synch
シーン再生中のみ60FPS固定にする=60 кадров в сценах
音量=Звук
ハードウェア=Память
モデルの\nキャッシュ\n=Model\ncache\n
　　※値が大きいほど読み込みが減りますが、その分VRAMを使用します。\n　　  目安： キャッシュ数 x (128 ～ 256[MB])=　　* More cached models means less loading, but higher up-front VRAM usage. Each model takes roughly 128-256MB.
ゲーム設定=Настройки игры
初期精力=Начальное <color%3D#00ff00>здоровье</color> 
勝敗条件=Условия проигрыша
通常=Все
精力のみ=Здоровье
無敵=Ничего
先行設定=Кто ходит первым
1P=Вы
CP=ИИ
初期手札交換=Разрешить обмен картами в начальных руках
1P有り=Вы
CP有り=ИИ
全搾精者を常に巨乳化状態にする=Установить огромную грудь на всех суккубах
初期手札の搾精者枚数を調整する=Фиксированное количество карт суккубов в вашей первоначальной руке
カードをアニメーションさせる=Анимация карт суккубов
カード会話を表示する=Диалоги суккубов
バトル中のスキップ操作を反転=Отключить все секс сцены, диалоги, и подтверждение действий NPC
搾精シーンをスキップしない=Не пропускать сцены секса.
プレイヤー操作をCPに任せる=Позвольте ИИ играть за вас
搾精対象の選択をなるべく省略する=Автоматически нацеливаться на противника, когда это возможно
CP搾精攻撃=Выбор атаки ИИ
優先度順=Приоритет
搾精値の予測表示をする=Показывать урон
搾精能力選択のサムネイルを表示する=Отображение миниатюр при выборе атак
CPの搾精攻撃をランダム選択にする=ИИ случайным образом выбирает иссушающие атаки
バトルBGM=Фоновая музыка битвы
標準=Нормальная
バトル背景=Фон секса
自パートナー=Ваш партнёр
相手パートナー=Враг партнер
毎ターン誘惑カットインを再生する=Вступительная заставка в начале каждого хода.
バトル中のシーン再生=Отображение секс сцен
自搾精者→自分=Игрок Сжиматель → Игрок
相手搾精者→自分=Враг Сжиматель → Игрок
自搾精者→相手=Игрок Сжиматель → Враг
相手搾精者→相手=Враг Сжиматель → Враг
搾精シーン=Сцена доения
搾精シーン設定=Настройки сцены секса
射精点滅=Эффект кульминации - Непрозрачность
表情の固定=Фиксированное выражение
発情描写表示=Показать эффекты эструса
表情を常に催眠状態にする=Гипноз
会話を非表示にする=Скрыть диалоги
会話による状態遷移を有効にする=Сцены развиваются на основе диалога
アナルを常に隠蔽処理する=Цензура ануса
口上による状態遷移を有効にする=Включить оральные переходы состояний
ズーム時間=Скорость увеличения
高速／低速\nアニメ切替閾値=Медленный / быстрый порог
Переключение,Удерживание=Таймер удержания
搾精を低速設定で開始する=Начинать с низкой скорости доения
優先して抽出する\n登録期間（日）=Приоритет колодам для боя.
30日=30 дней
sr:"(\d+)日"="$1 день"
各状態の設定=Настройки состояния
モーション初期速度=Скорость секса
自動遷移\n有効／無効=Автоматически прогресс
自動遷移\nまでの時間[с]	=Таймер
開始前=Прелюдия
搾精低速=Секс
搾精高速=Жёсткий секс
余韻=Кульминация
敗北後=Поражение
デバイス連動=Interlocking device
デバイス連動機能の使用=Connect to Automatic Fleshlight
A10SA接続=Vorze A10 Piston
接続しない=Not
VorzeUSB接続=VorzeUSB connection
速度係数=Velocity factor
　　※速度係数を調整する場合、\n　　大きい値から減らすようにしてください。=　　※ When adjusting the speed factor, be sure to reduce from the largest value.
ピストン型\n可動範囲=Piston type\nRange of movement
回転型デバイス\n反転周期=Rotating device\nReversal cycle
回転型デバイス\n速度範囲=Rotating device\nSpeed ​​range
UFO TW\n回転速度範囲=UFO TW\nRotation speed range
UFO TW:片側だけの動作をもう片側にミラーリング=UFO TW: Mirroring only one side of one side to the other side
更新=Обновить
投了=Сдаться
設定完了=Сохранить
ゲームを\n終了する=Выйти из игры
画面・音声=Звук/Видео
バトル設定=Настройки игры
デッキを削除しますか？=Хотите удалить эту колоду?
戻る=Отмена
KNT graphics／矢神ニーソ=KNT Graphics / Yagami Niso
タイガーリリー=Tiger Lily
フリーBGM・音楽素材MusMus=Free BGM · Music Material MUSMUS
西田光（勝気な精霊使い）=Nishida Hikari (Repressed Dryad)
とある教会裏のさとうきび畑／サッカルム=Top of the Church Background / Sakkalm
超次元覚醒研究所=Superdimensional Awakening Research Institute
青字クリックでブラウザを開きます。=Open a browser with a double click.
制作=Production
画像素材=Image material
クレジット=Разработчики
コラボサークル様=Collaboration circle
このゲームについて=О игре
スウィートラズベリー／あずきあらい=Sweet lasbury / Azuki
支援版=Поддерживаемая версия
体験版=Пробная версия
ゲーム開始=Начать игру
2020 超次元覚醒研究所=2020 Super Dimensional Awakening Institute
BGM、効果音=BGM, sound effects
このゲームは"カードバトル"と"搾精"をテーマにした一人用のゲームです。\n現在開発中のため、随時アップデートする予定です。\n現時点でできることは主に以下の通りです。\n\n・デッキの作成\n・デッキ別のキャラクター色変更\n・作成したデッキを使用してのCPとのバトル\n・Hアニメーションのリプレイ（搾精者編集にて）\n\nこれまでの開発状況など、詳細は支援サイトの過去記事をご参照願います。=This is a single-player card game with the theme of "squeezing".\n*Translator's Note: Don't panic, by 'Squeezing' they mean with mouths and vaginas, no Guro here.\nIt is currently under development and will be updated from time to time.\nThe main features thus far are as follows;\n-Create decks\n-Change character colors in decks\n-Battle with AI using your decks\n-Gallery Mode (In the 'Edit Squeezers' menu)\nPlease refer to the past articles on the support site for details such as the development status so far.
自動検出(Vorze_USB)=Automatic detection (Vorze_USB)
CPを自分で操作する=Управлять ИИ
オンライン機能=Онлайн
オンライン機能を有効にする=Включить онлайн функции
マップにオンラインデッキを表示する=Отображение онлайн-колод на карте мира
搾精記録=Рекорды выжимателей
バトル中の相手からの搾精を記録しない=Игнорировать враждебных выжимателей в бою.
搾られた総回数=Общее кол-во выжимания
搾られた総精力=Общая потеря энергии
パートナー回数=Время партнёра
搾精回数=Кол-во кончаний
搾られ方=Способности Кончить Для
搾精量=Потеряно жизни
搾り尽くした回数=Проигрыши
1回=Один раз
2回=Два раза
3回=Трижды
r:^([0-9]{3,})回=$1x
r:^([0-9]{1,2})回=$1 Times
//Guest Code by KitsuneZeta again. Adding the colors is a good idea, and the hardcoded values for above is also nice. Dunno what those two up there do, but they said it fixed a problem, so who cares I guess.
//1位=1ST
1位=<color%3D#FFD700>1ST</color>
//2位=2ND
2位=<color%3D#C0C0C0>2ND</color>
//3位=3RD
3位=<color%3D#CD7F32>3RD</color>
//Guest Code by timeracers. Stops the loading process from adding a new timestamped entry every time the game boots.
r:アセット読み込み完了 (\d{2}:\d{2}:\d{2}\.\d+)\nユーザ画像の読み込み開始\nユーザ画像の読み込み完了\n=Assets loaded at $1.\nUser assets loaded.\nReady to start.