初期精力=Начальная <color%3D#00ff00>энергия</color> 

勝敗条件=Условие поражения
通常=Все
精力のみ=Энергия
無敵=Ничего

先行設定=Кто ходит первым
1P=Игрок
CP=ИИ
CPを自分で操作する=Управлять ИИ

初期手札交換=Обмен картами в начальных руках
1P有り=Игрок
CP有り=ИИ

全搾精者を常に巨乳化状態にする=Модификатор BB на всех суккубах
初期手札の搾精者枚数を調整する=Ограничение карт-суккубов в первоначальной руке
カードをアニメーションさせる=Анимация карт суккубов
カード会話を表示する=Диалоги суккубов
バトル中のスキップ操作を反転=Отключить все секс сцены, диалоги, и подтверждение действий NPC
搾精シーンをスキップしない=Не пропускать сцены секса
プレイヤー操作をCPに任せる=Позвольте ИИ играть за вас
搾精対象の選択をなるべく省略する=Автоматически нацеливаться на противника, когда это возможно

CP搾精攻撃=Выбор атаки ИИ
標準=Нормальная
優先度順=Приоритет
ランダム=Случайно

搾精値の予測表示をする=Показывать урон
搾精能力選択のサムネイルを表示する=Отображение миниатюр при выборе атак
CPの搾精攻撃をランダム選択にする=ИИ случайным образом выбирает иссушающие атаки
バトルBGM=Фоновая музыка битвы
バトル背景=Фон секса
自パートナー=Ваш партнёр
相手パートナー=Враг партнёр
毎ターン誘惑カットインを再生する=Вступительная заставка в начале каждого хода.
バトル中のシーン再生=Отображение секс сцен

自搾精者→自分=Игрок Сжиматель → Игрок
相手搾精者→自分=Враг Сжиматель → Игрок
自搾精者→相手=Игрок Сжиматель → Враг
相手搾精者→相手=Враг Сжиматель → Враг